25 20
#############
#x..........#    ########
#...s...s...######.....w#
#.b.........D.B.w.......#
#...........######......#
#.....s.....#    #t..x..#
#...........#    #......#
#..S....k..w#    #......#
#####..######    ###..###
    #..#           #..#
    #..#           #..#
    #..#          ##..##
  ###..####      #.....w#
  #r......#      #b.....#
  #r......#      #......#
  #r......#      #......#
  #r....l.#      #......#
  #x......#      #...x..#
  #...kb..#      #......#
  #..@....#      #d.....#
  #########       ######
