25 20
#########################
#...........@...........#
#..........#.#..........#
#.........#...#.........#
#........#.....#........#
#.......#.......#.......#
#......#.........#......#
#.....#...........#.....#
#....#.............#....#
#...#...............#...#
#..#.................#..#
#.#########...#########.#
#.........#...#.........#
#........#..#..#........#
#.......#..#.#..#.......#
#......#..#...#..#......#
#.....#..#.....#..#.....#
#....#..#.......#..#....#
#.......................#
#########################
