6 50
1 2 3
######
#w...#
#....#
#.w.+#
#....#
#b...#
#.B..#
#...w#
#.w..#
#s...#
#...+#
#...b#
#+t..#
#....#
#..s.#
#g...#
#....#
#tt.s#
#...w#
#w...#
#...b#
#l...#
#tttD#
#....#
#.t..#
#.tw.#
#.t..#
#St.t#
#.t..#
#.t.k#
#.ttt#
#...s#
#w...#
#ttt.#
#l...#
#..t.#
#b.w.#
#.t..#
#tt.t#
#...w#
#ggt.#
#ggt.#
#ttt.#
#..w.#
#.ttt#
#.+..#
#..t.#
#gt..#
#u@..#
######
