6 50
1 2 3
######
#....#
#....#
#.w..#
#....#
#....#
#.B..#
#...w#
#.w..#
#s...#
#....#
#...b#
#.t..#
#....#
#..s.#
#r...#
#....#
#tt.s#
#...w#
#w...#
#...b#
#l...#
#tttD#
#....#
#.t..#
#.tw.#
#.t..#
#St.t#
#.t..#
#.t.k#
#.ttt#
#...s#
#w...#
#ttt.#
#l...#
#..t.#
#b...#
#.t..#
#tt.t#
#...w#
#rrt.#
#rrt.#
#ttt.#
#..w.#
#.ttt#
#....#
#..t.#
#rt..#
#u@..#
######
